18,7,1,1,1,1,1,8,1,1,1,1,1,9,19,
6,18,7,1,1,1,1,8,1,1,1,1,9,19,10,
1,6,0,0,0,22,0,0,0,22,0,0,0,10,1,
1,1,0,0,0,22,0,0,0,22,0,0,0,1,1,
1,1,0,0,0,22,0,0,0,22,0,0,0,1,1,
1,1,22,22,22,0,0,0,0,0,22,22,22,1,1,
1,1,0,0,0,0,0,22,0,0,0,0,0,1,1,
17,17,0,0,0,0,22,22,22,0,0,0,0,11,11,
1,1,0,0,0,0,0,22,0,0,0,0,0,1,1,
1,1,22,22,22,0,0,0,0,0,22,22,22,1,1,
1,1,0,0,0,22,0,0,0,22,0,0,0,1,1,
1,1,0,0,0,22,0,0,0,22,0,0,0,1,1,
1,16,0,0,0,22,0,0,0,22,0,0,0,12,1,
16,21,15,1,1,1,1,14,1,1,1,1,13,20,12,
21,15,1,1,1,1,1,14,1,1,1,1,1,13,20
